4 4 4 4 4 4 6 4 4 4 4 4 4 4 4 4 4 4 4 4 4 4 4 4 4 4 4 4 4 4 4 4 4 4 4 4 4 4 4 4 4 4 4 4 4 4 4 4 4 4 4 4 4 4 4 4 4 4 4 4
6 5 5 5 5 5 5 5 4 6 4 4 4 4 4 4 4 4 4 4 4 4 4 4 5 5 5 4 4 4 4 4 4 4 4 4 4 4 4 4 4 4 4 4 4 4 4 4 4 4 4 4 5 5 5 5 5 4 4 4
6 5 5 5 5 5 5 5 4 6 4 7 4 4 4 4 4 4 4 4 4 4 4 4 5 5 5 8 5 5 5 5 5 5 5 5 5 5 5 5 5 5 5 5 5 5 5 5 5 5 5 5 5 5 5 5 5 5 4 4
4 5 5 5 5 5 5 5 5 7 5 5 5 5 5 5 5 5 5 5 5 5 5 5 5 5 5 5 5 5 5 5 5 5 5 5 5 2 5 5 5 5 5 5 5 5 5 5 5 5 5 5 5 5 5 5 5 5 5 9
4 5 5 5 5 5 5 5 6 4 4 4 4 4 4 4 4 4 4 4 4 4 4 4 4 4 5 4 4 4 4 4 4 4 4 4 4 4 4 4 4 4 4 4 4 4 4 4 4 4 5 5 5 5 5 5 6 5 5 9
4 4 4 6 5 4 7 4 4 7 7 7 6 7 7 7 4 4 4 4 4 4 4 4 4 4 5 4 4 4 4 4 4 4 4 4 4 4 4 4 4 4 4 4 4 4 4 4 4 4 4 5 5 5 5 5 6 5 5 9
4 4 7 6 5 4 7 4 4 4 4 4 4 4 4 4 4 4 4 4 4 4 4 4 4 5 5 4 4 4 4 4 4 4 4 4 4 4 4 4 4 4 4 4 4 4 4 4 4 4 4 5 5 5 5 5 5 5 4 4
4 4 4 4 7 6 6 6 6 4 4 4 4 4 4 4 4 4 4 4 4 4 4 4 5 5 5 5 5 5 4 4 4 4 4 4 4 4 4 4 4 4 4 4 4 4 4 4 4 4 4 4 4 4 4 2 2 2 4 4
7 7 7 4 5 4 4 4 4 4 4 4 4 4 4 4 4 4 4 4 4 4 4 5 5 5 5 5 5 5 5 4 4 4 4 4 4 4 4 4 4 4 4 4 4 4 4 4 4 4 4 4 4 4 4 5 5 5 4 4
4 6 4 4 5 5 4 7 7 7 6 4 4 4 4 4 4 4 4 4 6 4 5 5 2 5 5 5 5 5 5 5 4 6 7 4 4 4 4 4 4 4 4 4 4 4 4 4 4 4 4 4 4 4 4 5 5 5 4 4
4 4 4 7 4 5 4 4 6 4 4 4 4 4 4 4 4 6 4 4 4 4 5 5 5 5 5 5 2 5 5 5 4 4 4 4 7 4 4 4 4 4 4 4 4 4 4 4 4 4 4 4 4 4 4 5 5 5 4 4
4 6 4 4 4 5 4 4 4 7 4 4 6 4 4 4 4 4 4 4 4 4 5 5 2 5 5 5 5 5 5 5 5 5 5 5 5 4 4 4 4 4 4 4 4 4 4 4 4 4 4 4 4 4 5 5 5 4 4 4
4 6 5 5 5 5 5 5 5 5 4 4 6 6 4 4 4 5 5 5 6 4 4 5 5 5 5 5 5 5 5 4 4 4 4 4 5 5 4 4 4 4 4 4 4 4 4 4 4 4 4 4 4 4 5 5 5 4 4 4
4 6 5 5 5 5 5 5 5 5 5 4 4 4 4 4 4 5 5 5 4 4 4 4 5 5 5 5 5 5 4 4 4 4 4 4 5 5 4 4 4 4 4 4 4 4 4 4 4 4 4 4 4 4 2 5 5 4 4 4
4 5 2 5 5 5 5 5 5 5 5 7 4 7 4 5 5 5 5 5 4 4 4 4 4 4 5 5 4 4 4 4 4 4 4 7 5 5 4 4 4 4 4 4 4 4 4 4 4 4 4 4 4 4 5 5 5 4 4 4
4 7 5 5 5 5 5 5 5 5 5 4 4 4 4 5 4 4 4 4 6 4 6 6 4 4 4 5 5 4 7 4 4 6 4 4 4 5 5 4 4 4 4 4 4 4 4 4 4 4 4 4 4 4 5 5 5 4 4 4
4 5 5 5 5 5 5 2 5 5 5 5 5 5 5 5 4 4 4 4 4 4 4 4 4 4 4 5 5 4 4 7 4 4 4 4 4 4 5 5 4 4 4 4 4 4 4 4 4 4 4 4 4 4 5 5 5 4 4 4
4 4 4 4 8 4 4 4 4 4 4 4 4 4 4 4 4 4 4 4 4 4 4 6 4 4 4 4 5 5 4 4 4 4 6 7 4 5 5 2 5 4 4 4 4 4 4 4 4 4 4 4 4 4 4 5 5 5 4 4
4 6 4 5 5 5 4 4 4 4 4 4 4 4 4 4 4 6 4 4 6 4 4 4 4 4 4 4 5 5 4 4 6 4 4 4 5 5 5 5 5 5 4 4 4 4 4 4 4 4 4 4 4 4 4 5 5 5 4 4
4 6 4 5 5 5 4 4 4 4 4 4 4 4 4 4 4 4 4 4 4 4 4 4 4 4 4 4 5 5 4 6 4 4 4 4 5 5 2 5 5 5 4 4 4 4 4 4 4 4 4 4 4 4 4 5 5 5 4 4
4 4 7 5 5 5 4 4 4 4 4 4 4 4 4 4 4 4 4 4 4 4 4 4 7 4 4 4 5 5 4 6 4 4 4 4 4 5 5 5 5 5 5 4 4 4 4 4 4 4 4 4 4 4 4 5 5 5 4 4
4 4 4 5 5 5 4 4 6 4 4 4 4 4 4 4 6 4 4 6 6 4 6 4 4 7 6 4 5 5 4 4 4 6 4 4 4 4 5 5 4 5 5 5 4 4 4 4 4 4 4 4 4 4 4 5 5 5 4 4
4 6 4 5 5 5 4 4 4 4 4 4 4 4 4 4 4 4 4 4 4 4 4 4 4 4 4 4 5 5 4 4 4 6 6 4 6 4 5 5 4 4 5 5 5 4 4 4 4 4 4 4 4 4 4 5 5 5 4 4
4 7 4 5 5 5 4 4 4 4 4 4 4 4 4 4 4 4 4 4 4 6 4 4 6 4 5 5 5 5 5 5 5 5 5 5 5 5 5 4 4 4 4 5 5 4 4 4 4 4 4 4 4 4 4 5 5 5 4 4
4 4 4 5 5 5 4 4 6 4 4 4 4 6 4 4 4 4 4 4 4 4 4 4 4 4 5 5 2 5 5 5 5 5 5 5 4 4 4 4 4 5 5 5 5 5 5 5 5 5 5 5 5 5 4 5 5 5 4 4
6 4 7 5 5 5 4 4 4 4 4 4 4 6 4 4 6 4 4 6 4 4 4 6 4 7 5 5 5 5 5 5 5 5 5 5 6 4 4 4 5 5 5 5 5 5 5 5 5 5 5 5 5 5 4 5 5 5 4 4
7 4 4 4 5 5 5 4 7 7 7 4 4 4 4 4 4 7 4 4 4 4 4 4 4 4 5 5 5 5 5 5 5 5 5 5 4 4 4 4 4 5 5 5 5 2 5 5 5 2 5 5 5 5 4 5 5 5 4 4
4 4 4 4 5 5 5 4 4 4 4 4 6 4 4 4 4 4 4 7 4 7 4 7 7 4 5 5 5 5 5 5 2 5 5 5 4 7 4 4 4 5 5 5 5 5 5 5 5 5 5 5 5 5 5 5 5 5 4 4
4 4 4 4 5 5 5 6 4 4 4 4 4 4 4 4 6 6 4 4 4 6 4 4 4 4 5 5 5 5 5 5 5 5 5 5 4 4 6 4 4 5 5 5 5 5 5 5 5 5 5 5 5 5 5 5 5 4 4 4
6 6 4 4 5 5 5 7 7 7 4 4 4 4 4 7 4 4 4 4 4 4 4 4 4 7 4 4 4 5 5 5 5 4 4 4 4 4 4 4 5 5 5 5 5 2 5 5 5 5 2 5 5 5 4 4 4 4 4 4
4 4 4 5 5 5 4 4 4 4 6 4 7 4 4 7 4 4 4 7 4 4 4 6 7 4 4 4 4 4 4 5 4 4 7 4 4 4 4 4 5 5 5 5 5 5 5 5 5 5 5 5 5 5 4 4 4 4 4 4
4 7 4 5 5 5 4 4 4 4 4 4 4 4 4 7 4 4 4 4 4 6 4 4 4 4 6 6 4 7 4 8 4 4 4 4 4 6 4 4 4 5 2 5 5 5 5 5 2 5 5 5 5 5 4 4 4 4 4 4
4 4 5 5 5 5 5 5 5 5 4 4 7 6 4 4 6 4 4 4 4 4 4 6 4 4 4 4 4 4 5 5 4 4 4 4 4 4 4 4 4 5 5 5 5 5 5 5 5 5 5 4 4 4 4 4 4 4 4 4
4 5 5 5 5 5 5 5 5 5 5 5 4 4 4 4 4 4 5 5 5 5 5 5 4 6 4 6 6 4 5 5 4 6 4 6 4 4 4 4 4 4 4 4 4 4 4 4 4 4 4 4 4 4 4 4 4 4 4 4
4 5 5 5 5 5 5 5 5 5 5 5 6 4 4 4 4 4 5 5 4 4 4 5 5 4 4 6 4 4 5 5 4 6 7 4 4 4 4 4 4 4 4 4 4 4 4 4 4 4 4 4 4 4 4 4 4 4 4 4
4 5 5 5 5 5 5 5 5 5 5 5 4 6 7 7 4 4 5 5 7 4 7 5 5 4 4 4 4 4 5 5 4 4 4 4 4 4 4 4 4 4 4 4 4 4 4 4 4 4 4 4 4 4 4 4 4 4 4 4
4 5 5 5 5 2 5 5 5 5 5 5 6 4 4 5 5 5 5 5 4 4 4 4 5 5 4 4 4 5 5 4 7 4 4 4 4 4 4 4 4 4 4 4 4 4 4 4 4 4 4 4 4 4 4 4 4 4 4 4
4 5 5 5 5 5 5 5 5 5 5 5 5 5 5 5 5 5 4 4 7 4 4 4 4 5 5 5 5 5 5 4 4 6 4 4 4 4 4 4 4 4 4 4 4 4 4 4 4 4 4 4 4 4 4 4 4 4 4 4
4 5 5 5 5 5 5 5 5 2 5 4 4 4 6 4 4 6 4 6 4 4 4 4 4 4 7 4 4 7 4 4 4 4 4 4 4 4 4 4 4 4 4 4 4 4 4 4 4 4 4 4 4 4 4 4 4 4 4 4
4 4 4 4 4 4 4 4 4 4 4 4 4 4 4 4 4 4 4 4 4 4 4 4 4 4 4 4 4 4 4 4 4 4 4 4 4 4 4 4 4 4 4 4 4 4 4 4 4 4 4 4 4 4 4 4 4 4 4 4